#######
#..B#.#
#O.#..#
#..#..#
#######
