#######
#O...B#
#.###.#
#.....#
#######
