#######
#O....#
#.#.#.#
#..B#.#
#######
